0,0,0,0,0,0,0,0,0,0,0,0,0,0,0,0
0,1306,1902,1902,0,1902,1902,1306,0,0,0,0,0,0,0,0
0,1306,0,0,0,0,0,1306,0,0,0,0,0,0,0,0
0,1306,0,0,0,0,0,1306,0,0,0,0,0,0,0,0
0,1306,0,0,0,0,0,1306,0,0,0,0,0,0,0,0
0,1306,0,0,0,0,0,1306,0,0,0,0,0,0,0,0
0,1306,1902,1902,0,1902,1902,1306,0,0,0,0,0,0,0,0
0,0,0,0,0,0,0,0,0,0,0,0,0,0,0,0
0,0,0,0,0,0,0,0,0,0,0,0,0,0,0,0
0,0,0,0,0,0,0,0,0,0,0,0,0,0,0,0
0,0,0,0,0,0,0,0,0,0,0,0,0,0,0,0
