w,w,w,w,w,w,w,w,w,w
w,x,x,x,x,x,x,x,x,w
w,h,h,x,x,x,x,x,x,w
w,h,h,x,p,p,p,p,p,@
w,x,x,x,p,x,x,x,x,w
w,x,x,x,p,x,x,x,x,w
w,x,x,x,p,x,s,x,x,w
w,x,x,x,p,x,x,x,x,w
w,x,x,x,p,x,x,x,x,w
w,w,w,w,@,w,w,w,w,w
